; Niveau 014 - L'entrepot ouvert
##########################
#                        #
#  $  $  $  $  $  $  $   #
#                        #
#  ######################
#  #                     #
#  #  . . . . . . .      #
#  #                     #
#  #  . . . . . . .      #
#  #                     #
#  ######################
#                        #
#   $  $  $  $  $  $  $  #
#                        #
#              @         #
#                        #
##########################
